1000000000000000
1110000111110000
0010000100010000
0011110100010000
0000010100010000
0000011100011111
0000000000000000
0000000000000000